NO ./textures/north.xpm
SO ./textures/south.xpm
WE ./textures/west.xpm
EA ./textures/east.xpm

F 100,100,100
C 50,50,150

111111111111111111111
100000000000000000001
100000000000000000001
100000000000000000001
10000000000N000000001
100000000000000000001
100000000000000000001
100000000000000000001
111111111111111111111
