NO ./textures/north.xpm
SO ./textures/south.xpm
WE ./textures/west.xpm
EA ./textures/east.xpm

F 50,50,50
C 20,20,20

11111111111111111
10000001000000001
10111101011111101
10100001000000101
10101111111110101
10100000000010101
11111111110010101
10000000010010101
10111111010010101
10100001010010101
10101101010010101
10101101010010101
10101101010000001
101011S1011111101
10101111000000001
10100000011111111
11111111111111111
