NO ./no.xpm
SO ./so.xpm
WE ./we.xpm
EA ./ea.xpm
F  0,128,0
C  50,50,50

  111111
  100001
  10S001
  111111

