NO ./textures/north.xpm
SO ./textures/south.xpm
WE ./textures/west.xpm
EA ./textures/east.xpm

F 80,60,40
C 135,206,235

1111111111111
1000000000001
1000000000001
1000111000001
1000101000001
10001N1000001
1000111000001
1000000000001
1000000000001
1111111111111